1111111111111111
1E0C0C0C0C0C0C01
1G111111110C1001
1C000000C001G0C1
1C01C111C0C0C0C1
1C00G0C0G0C0C0C1
1C01111111111C01
1C0C0C0C0C0C0C01
111111111111G0C1
1C0C0C0C0C0C0C01
1C011111111111C1
1C01G0C0C0C0C0C1
1C011111111111C1
1C0C0C0C0C0C0P01
1111111111111111