111111111111
1P0000000001
110001111001
100001000001
100000C00001
100111110001
100000010001
101110111101
1010C0001001
100011110001
1E00000000C1
111111111111