11111111111111111111
10000C0000G00C000001
10000100100010000001
10110101110101110C01
1000010C000100000001
10110111011101110101
10100G00010000000101
10101011101011101001
1000000000G100000001
10110111011101110101
10000000000C00010001
1P110101110101101101
1E000000000000000001
11111111111111111111